R 500 500
NO ./srcs/textures/colorstone.xpm
SO ./srcs/textures/wood.xpm
WE ./srcs/textures/redbrick.xpm

EA ./srcs/textures/texture15.xpm
S ./srcs/textures/chest.xpm

F 220,100,0

C 225,30,0


        1111111111111111111111111
        1000000000110000000000001
        1011000001110002002002001
        1001000E00000000000000001
111111111011000001110000000000001
100000000000000001110111111111111
11110111111111011100000010001
11110111111111011101010010001
11000000110101011100000010001
10002000000000001100000000001
10000000000000001101010010001
1100000111010101111101111000111
11110111 1110101 101111010001
11111111 1111111 111111111111