R 1920 1080
NO ./src/textures/runewall.xpm
SO ./src/textures/runedoor.xpm
WE ./src/textures/slabwall.xpm

EA ./src/textures/woodwall.xpm



BX ./src/textures/skybox.xpm

S ./src/textures/chest.xpm

F 220,100,0

C 225,30,0


11111111111111111111111111111111111111
1E000000000000000000000000000000000001
10000000000000000000000000000000000001
10000000000000000000000000000000000001
10000000000000000000000000000000000001
10000000000000000000000000000000000001
10000000000000000000000000000000000001
10000000000000000000000000000000000001
10000000000000000000000000000000000001
10000000000000000000000000000000000001
10000000000000000000000000000000000001
10000000000000000000000000000000000001
10000000000000000000000000000000000001
10000000000000000000000000000000000001
11111111111111111111111111111111111111