R 1920 1080
NO ./src/textures/hierowall.xpm
SO ./src/textures/hierowall.xpm
WE ./src/textures/hierowall.xpm
EA ./src/textures/hierowall.xpm

BX ./src/textures/skybox.xpm

S ./src/textures/pillar.xpm
O1 ./src/textures/hpot.xpm
O2 ./src/textures/cobra.xpm
O3 ./src/textures/sarcophagus.xpm

T1 ./src/textures/portal1.xpm
T2 ./src/textures/portal2.xpm
T3 ./src/textures/portal3.xpm
T4 ./src/textures/portal4.xpm

HB ./src/textures/healthbar.xpm
GO ./src/textures/gameover.xpm
ED ./src/textures/endscreen.xpm

DC ./src/textures/hierodoor.xpm
K1 ./src/textures/orb_red.xpm
K2 ./src/textures/orb_green.xpm

F 253 ,   223,119
C 155,     163     ,  164

MC ./src/audio/stage_9.mp3
ML 151

                            111111111
                            105050051
                            150000501
                            111101111
             111               101
            11911  11111111111110111111111111111111
            10001  1K000000000000000000000000000001
          11117111111111111111111111111111111111171
          100000001K1000100016001000100010001K1 101
          1020202010101010101016101610101010101 101
          1000000016101016100010001000101610101 101
          1020402010101010111111011111101010101 101
          1000000010101010120000000002161010101 101
          1020202010101016100000000000101016101 101
          1000000010061000100000000000100010001 101
111111111111117111111111111000200020001111111111101111
16600006061  161K000102420100000S000000000000000000001
10006000661  10111101506051000200020001110111011111101
1606660006111101  101120211000000000001 101 101    101
160006660010K101  107000006000000000001 161 151    101
1006606660101171  111120211200000000021 101 101    101
1600660660101001  1K1500051111110111111 101 101    101
166000666K101011  1011111112552101      101 101    101
111110111117101   1000000000000001    11101110111  101
    101   10001   1111111011111111    15005160661  101
   11011  11011         101           150K016K061  101
  1100011  101       111101111        11111111111  101
 110000011 101       150000051                     101
110022200111011111111111171111111111111111111111111101
100024000000001000000000000000000000000000070000000001
110022200111101011111111111111111011111111111111111111
 110000011  10001               101
  1100511   11111             1110111
   11111                      1K000K1
                              1111111