R 1920 1080
NO ./src/textures/brickwall.xpm
SO ./src/textures/brickwall.xpm
WE ./src/textures/brickwall.xpm
EA ./src/textures/brickwall.xpm

BX ./src/textures/skybox.xpm

S ./src/textures/barrel.xpm
O1 ./src/textures/hpot.xpm
O2 ./src/textures/cobra.xpm
O3 ./src/textures/pillar.xpm

T1 ./src/textures/portal1.xpm
T2 ./src/textures/portal2.xpm
T3 ./src/textures/portal3.xpm
T4 ./src/textures/portal4.xpm

HB ./src/textures/healthbar.xpm
GO ./src/textures/gameover.xpm

DC ./src/textures/runedoor.xpm
K1 ./src/textures/orb_red.xpm
K2 ./src/textures/orb_green.xpm

F 253 ,   223,119
C 155,     163     ,  164

NL src/maps/level7.cub

MC ./src/audio/stage_7.mp3
ML 110

111111111111111111111111111111111111111111111111111111111111111111111111111111111111111111111111111111111111111111111111111
1E0000000000000000000000000000000000000000000000000000000000000000000000000000000000000000000000000000000000000000000000001
131111111111111111111111111111111111111111111111111111111111111111111111111111111111111111111111111111111111111111111111101
100000000000000000000000000000000000000000000000000000000000000000000000000000000000000000000000000000000000000000000000001
191111111111111111111111111111111111111111111111111111111111111111111111111111111111111111111111111111111111111111111111111
111