R 1920 1080
NO ./src/textures/hierowall.xpm
SO ./src/textures/ground.xpm
WE ./src/textures/mosswall.xpm
EA ./src/textures/cobblewall.xpm

BX ./src/textures/skybox.xpm
DC ./src/textures/hierodoor.xpm
HB ./src/textures/healthbar.xpm

K1 ./src/textures/orb_red.xpm
K2 ./src/textures/orb_green.xpm

O1 ./src/textures/hpot.xpm
O2 ./src/textures/cobra.xpm

O3 ./src/textures/pillar.xpm

T1 ./src/textures/portal1.xpm
T2 ./src/textures/portal2.xpm
T3 ./src/textures/portal3.xpm
T4 ./src/textures/portal4.xpm

GO ./src/textures/gameover.xpm
ED ./src/textures/endscreen.xpm

S ./src/textures/sarcophagus.xpm



F 253 ,   223,119

NL ./src/maps/test2.cub

C 0,     255     ,  0



11111   1111111111111111111111111
10001   1000000000110060050040091
113111111011000001110000000000001
100000000000000000000000000000E21
1131111110110000011100K0000000001
100000000000000001117111111111111
111101111111110111000K0010001
11110111111111011101010010001
11000000110101011100000010001
10000000000000001100000000001
10000000000000001101010010001
1100000111010101111101111000111
11110111 1110101 101111010001
11111111 1111111 111111111111